DATASET_COLORSTRIP
SEPARATOR TAB
DATASET_LABEL	Family strips
COLOR	#2986cc
COLOR_BRANCHES	0
SHOW_INTERNAL	0
STRIP_WIDTH	40
SHOW_STRIP_LABELS	0
DATA
Cibotium_menziesii|Cibotium_arachnoideum	#2EF5F3	family
Culcita_coniifolia|Culcita_macrocarpa	#F822F9	family
Cyathea_pungens|Sphaeropteris_novae-caledoniae	#ECE91C	family
Dicksonia_archboldii|Calochlaena_straminea	#FE473D	family
Loxsoma_cunninghamii|Loxsomopsis_pearcei	#7D475D	family
Metaxya_rostrata|Metaxya_parkeri	#006CE6	family
Plagiogyria_japonica|Plagiogyria_pectinata	#1CFB6D	family
Equisetum_ferrissii|Equisetum_bogotense	#356A00	family
Cheiropleuria_bicuspis|Dipteris_conjugata	#D38022	family
Sticherus_compactus|Gleichenella_pectinata	#F542A6	family
Matonia_pectinata|Phanerosorus_major	#BBC5FE	family
Crepidomanes_inopinatum|Hymenophyllum_paniense	#EEDCBA	family
Angiopteris_cartilagidens|Danaea_erecta	#7C1C9F	family
Botrychium_ascendens|Mankyua_chejuense	#FA96E4	family
Osmunda_lancea|Osmundastrum_cinnamomeum	#9B0DFF	family
Asplenium_coenobiale|Hymenasplenium_hoffmannii	#95F4B0	family
Diplazium_macrophyllum|Deparia_nanakuraensis	#1C4D72	family
Parablechnum_lechleri|Salpichlaena_papyrus	#FE96A4	family
Cystopteris_diaphana|Gymnocarpium_robertianum	#7AABA8	family
Diplaziopsis_cavaleriana|Homalosorus_pycnocarpos	#856616	family
Onocleopsis_hintonii|Pentarhizidium_orientale	#0DCCFE	family
Rhachidosorus_pulcher|Rhachidosorus_mesosorus	#AAF322	family
Christella_procera|Macrothelypteris_polypodioides	#B21645	family
Woodsia_ilvensis|Physematium_manchuriensis	#F7CDE8	family
Hypolepis_hostilis|Monachosorum_maximowiczii	#9F1C70	family
Lindsaea_hemiglossa|Sphenomeris_clavata	#AD8BFD	family
Lonchitis_hirsuta|Lonchitis_occidentalis	#FDD379	family
Davallia_griffithiana|Davallia_pubescens	#A3C256	family
Didymochlaena_fijiensis|Didymochlaena_sinuosa	#FD7958	family
Dryopteris_cycadina|Parapolystichum_currorii	#E97FFE	family
Hypodematium_brevipilosum|Leucostegia_pallida	#DB16BB	family
Lomariopsis_boivinii|Dryopolystichum_phaeostigma	#0D79BE	family
Nephrolepis_hirsutula|Nephrolepis_rivularis	#1CAD35	family
Oleandra_wallichii|Oleandra_distenta	#916DA7	family
Archigrammitis_ponapensis|Dictymia_brownii	#3B5645	family
Tectaria_hilocarpa|Arthropteris_articulata	#F41C79	family
Doryopteris_sagittifolia|Acrostichum_danaeifolium	#1CA882	family
Saccoloma_elegans|Orthiopteris_ferulacea	#C29081	family
Tmesipteris_obliqua|Psilotum_complanatum	#8DA980	family
Marsilea_angustifolia|Regnellidium_diphyllum	#D5E3F7	family
Azolla_filiculoides|Salvinia_cucullata	#6C32D1	family
Anemia_hispida|Anemia_colimensis	#9A3542	family
Lygodium_kerstenii|Lygodium_palmatum	#DFADFD	family
Schizaea_incurvata|Actinostachys_digitata	#CD3DFB	family
